50 70
3 3 3 3 3 3 3 3 3 3 3 3 3 3 3 3 3 3 3 3 3 3 3 3 3 3 3 3 3 3 3 3 3 3 3 4 3 3 3 3 3 3 3 3 3 3 3 3 3 3 3 3 3 3 3 3 3 3 3 3 3 3 3 3 3 3 3 3 3 3
3 7 7 7 7 7 7 7 7 7 7 7 7 7 7 7 7 7 7 7 7 7 7 7 7 7 7 7 7 7 7 7 7 7 7 7 7 7 7 7 7 7 7 7 7 7 7 7 7 7 7 7 7 7 7 7 7 7 7 7 7 7 7 7 7 7 7 7 7 3
3 7 3 3 3 3 3 3 3 3 3 3 7 3 3 3 3 3 3 3 3 3 3 7 3 3 3 7 3 3 3 7 3 3 3 3 3 3 3 3 3 3 3 3 3 3 3 3 3 3 3 3 3 3 3 3 3 3 3 3 3 3 3 3 3 3 3 3 7 3
3 7 7 7 7 7 7 7 7 7 7 3 7 3 7 7 7 7 7 3 7 7 7 7 7 7 3 3 3 7 3 3 3 3 7 7 7 7 7 7 7 7 7 7 7 7 7 7 7 7 7 7 7 7 7 7 7 7 7 7 7 7 7 7 7 7 3 7 7 3
3 7 3 3 7 3 3 3 7 3 7 3 7 3 7 3 3 3 7 3 7 3 3 3 3 7 3 7 7 7 7 7 7 3 7 3 3 3 3 3 3 3 3 3 3 3 3 7 7 3 3 7 3 3 3 3 3 3 7 3 3 7 3 3 3 3 3 3 7 3
3 7 3 7 7 7 3 7 7 3 7 3 3 3 7 3 7 3 7 3 7 7 7 7 7 7 3 7 3 3 3 3 7 3 7 3 7 7 3 3 7 3 7 7 7 7 3 3 3 3 7 7 3 7 7 7 3 7 7 3 3 3 3 7 7 7 7 3 7 3
3 7 3 3 3 3 3 3 3 3 7 7 7 7 7 3 7 3 7 3 7 3 3 3 3 3 3 7 3 7 7 3 7 3 7 3 7 3 3 7 7 7 7 3 3 7 7 7 7 7 7 3 3 3 3 7 3 3 3 3 7 7 3 3 7 7 7 7 7 3
3 7 7 7 7 7 7 7 7 3 3 3 7 3 3 3 7 7 7 3 7 3 3 7 7 7 7 7 7 7 3 3 7 3 7 7 7 7 3 7 3 3 3 3 3 3 3 3 3 3 3 3 3 7 7 7 7 7 7 7 7 7 7 7 7 7 7 7 7 3
3 7 3 3 3 3 3 3 3 3 3 3 3 3 3 3 7 3 7 3 7 7 3 7 3 3 3 3 3 7 3 3 7 3 3 3 3 3 3 7 3 7 7 7 7 7 7 7 7 7 7 7 7 7 3 3 3 7 3 3 7 7 3 7 3 3 3 3 7 3
3 7 7 7 7 7 7 7 7 3 7 7 7 7 7 3 7 3 7 3 3 7 3 7 3 7 7 7 7 7 7 3 7 7 7 7 7 7 7 7 3 7 3 3 3 3 3 3 3 3 3 7 3 7 7 3 3 3 3 3 7 3 3 3 3 7 7 3 7 3
3 7 3 3 3 3 3 3 3 3 7 3 3 3 7 3 7 3 7 3 3 7 3 7 3 3 3 3 3 3 7 3 7 3 3 7 3 3 3 7 3 7 7 7 7 7 7 7 7 7 3 7 7 7 7 7 7 7 7 7 7 7 7 7 3 7 7 7 7 3
3 7 7 7 7 7 7 7 7 3 7 3 7 3 7 3 7 3 7 3 7 7 3 7 3 7 7 3 7 7 7 3 7 3 7 7 7 7 3 7 3 3 3 3 3 3 3 3 3 7 3 3 3 3 3 3 3 3 3 3 3 3 3 3 3 3 3 7 7 3
3 3 3 3 3 3 3 3 3 3 7 3 7 3 7 3 3 3 7 3 7 3 3 7 3 7 3 3 3 3 7 3 7 3 7 3 3 3 3 7 7 7 7 7 7 7 7 7 3 7 7 3 7 7 7 7 7 7 7 7 7 7 7 7 7 7 7 7 7 3
3 7 7 7 7 7 7 7 7 7 7 3 7 7 7 7 7 7 7 3 7 3 7 7 3 7 7 7 7 7 7 3 7 3 7 3 3 7 3 3 3 3 3 3 3 3 3 7 3 7 7 7 7 3 3 3 3 3 3 3 3 3 3 3 3 3 3 3 7 3
3 7 3 3 3 3 3 3 3 3 7 3 3 3 3 3 3 3 3 3 3 3 7 3 3 3 3 3 3 3 3 3 7 3 7 3 3 7 7 7 7 3 3 7 3 7 3 7 3 3 3 3 3 3 7 7 7 7 7 7 7 7 7 7 7 7 7 3 7 3
3 7 7 7 3 3 3 3 7 7 7 3 7 7 7 7 7 7 7 7 7 7 7 3 7 3 7 7 7 7 3 3 7 3 7 3 7 7 3 3 7 7 7 7 3 7 3 7 7 7 7 7 7 3 7 7 3 7 3 3 3 3 3 3 3 3 7 3 7 3
3 7 3 7 7 7 7 3 3 7 3 3 7 3 3 3 3 3 7 3 3 3 3 3 7 3 7 3 3 7 3 3 7 3 7 3 7 3 3 3 3 3 3 3 3 7 3 7 3 7 7 3 7 3 7 7 3 7 7 7 7 7 7 7 7 3 7 3 7 3
3 7 3 3 3 3 3 3 3 3 3 3 7 3 7 3 3 3 3 3 3 3 7 7 7 3 7 3 3 7 7 7 7 3 7 3 7 7 7 7 7 7 7 7 7 7 3 7 3 3 3 3 3 3 3 3 3 3 3 3 3 3 3 3 3 3 7 3 7 3
3 7 7 7 7 7 7 7 7 7 7 7 7 3 7 3 7 7 7 7 7 3 7 7 7 7 7 3 3 3 3 3 3 3 7 3 3 3 3 3 3 3 7 3 3 3 3 7 7 7 3 3 3 7 3 7 7 7 7 7 3 7 3 7 7 7 7 3 7 3
3 3 3 3 7 3 3 3 7 3 3 3 3 3 7 7 7 3 3 3 7 3 7 7 7 3 7 3 7 7 7 7 7 7 7 3 3 7 7 7 7 7 7 3 7 7 7 7 3 7 3 7 7 7 3 7 3 7 3 7 7 7 7 7 3 3 3 3 7 3
3 7 3 3 3 3 7 3 3 3 3 3 7 7 7 3 7 3 7 3 7 3 3 3 3 3 7 3 7 7 3 3 3 3 3 3 7 7 3 3 7 3 7 3 3 3 3 3 3 3 3 3 3 7 3 3 3 3 3 3 3 7 7 7 3 7 7 7 7 3
3 7 7 7 7 7 7 7 7 7 7 3 3 3 3 3 7 3 7 3 7 7 7 7 7 7 7 3 7 3 3 7 3 7 3 3 7 7 7 3 3 3 7 3 3 7 7 7 7 7 7 3 7 7 7 7 3 7 3 7 3 7 7 7 3 7 3 3 3 3
3 7 3 3 3 3 7 3 3 3 7 7 7 7 3 3 7 3 7 3 3 3 3 3 3 3 3 3 7 7 7 7 7 7 7 3 7 3 7 7 3 7 7 3 3 3 3 3 3 7 3 3 7 3 3 3 3 7 3 7 3 7 3 7 3 7 3 7 7 3
3 7 7 7 3 7 7 7 7 3 3 3 3 7 3 3 7 3 7 7 7 7 7 7 3 3 3 3 3 3 3 3 3 3 7 3 3 3 3 3 3 3 7 7 3 7 7 7 7 7 7 3 7 7 7 7 7 7 3 7 3 7 3 7 3 7 3 3 7 3
3 3 3 7 3 7 3 3 3 3 3 7 3 7 7 7 7 3 7 3 3 3 3 7 3 7 7 7 7 7 7 7 7 3 7 3 7 7 7 7 7 7 7 7 3 7 7 3 3 3 7 3 7 3 3 3 3 3 3 7 3 7 3 7 3 7 7 3 7 3
3 3 7 7 3 7 7 7 7 7 3 7 3 3 3 3 3 3 7 3 3 7 7 7 3 7 3 3 3 3 3 3 7 3 7 3 7 7 7 3 3 7 3 3 3 7 3 3 7 3 7 3 7 3 7 3 7 7 7 7 3 7 3 7 3 3 7 3 7 3
3 3 7 3 3 7 3 3 3 3 3 7 7 7 7 7 3 3 3 3 7 7 3 3 3 7 3 7 3 3 7 3 7 3 7 7 7 3 3 3 3 3 3 3 3 7 7 3 7 7 7 3 7 7 3 7 7 7 3 7 7 3 7 7 3 7 7 3 7 3
3 7 7 3 7 7 7 7 7 7 7 7 3 7 3 7 7 7 7 3 3 7 3 7 7 7 7 7 3 7 7 3 7 3 3 3 3 3 7 7 7 7 7 7 3 7 3 3 3 3 3 3 7 3 3 3 3 3 3 7 7 7 7 7 3 3 7 3 7 3
3 7 3 3 7 3 3 3 3 3 3 3 3 3 3 3 3 3 7 3 3 7 3 7 3 3 7 7 3 3 7 3 7 7 7 7 7 3 7 3 3 3 3 7 3 7 7 7 3 7 7 7 7 7 3 7 7 7 3 7 3 7 3 3 3 3 7 3 7 3
3 7 3 7 7 3 7 7 7 7 7 7 7 7 7 7 7 3 7 3 3 7 3 7 3 7 7 7 7 7 7 3 7 3 7 7 3 3 7 3 7 3 3 7 3 7 3 3 3 3 3 3 3 7 3 3 3 7 3 7 3 7 3 7 7 3 7 3 7 3
3 7 3 3 3 3 7 3 3 3 3 3 3 7 7 3 7 3 7 7 3 7 3 7 3 3 3 7 3 3 3 3 3 3 7 7 7 7 7 3 7 7 3 7 3 7 7 7 7 7 7 7 7 7 7 7 7 7 3 7 3 7 3 7 3 3 7 3 7 3
3 7 7 7 7 7 7 7 7 7 7 3 7 7 7 3 7 3 7 3 3 7 3 7 7 7 3 7 3 7 7 7 7 3 3 3 7 7 3 3 7 3 3 7 3 3 3 3 3 3 3 3 3 3 3 3 7 3 3 7 3 7 3 7 7 3 7 3 7 3
3 3 3 3 3 3 3 3 7 3 3 3 7 3 3 3 7 3 7 7 7 7 3 3 3 7 3 7 3 7 3 3 7 7 7 3 3 3 3 7 7 7 3 7 7 7 7 7 7 7 7 7 7 7 7 3 7 3 7 7 3 7 3 3 7 3 7 3 7 3
3 7 7 7 7 7 7 7 7 7 3 7 7 7 7 3 7 3 3 3 3 3 3 7 3 7 3 7 3 7 3 3 7 7 7 7 7 3 3 7 3 7 3 3 7 7 7 3 7 3 3 3 3 3 7 3 7 3 7 3 3 7 7 7 7 3 7 3 7 3
3 7 3 7 3 7 3 3 3 3 3 3 3 3 3 3 7 7 7 7 7 7 3 7 3 7 3 3 3 7 7 3 3 3 3 3 7 7 3 7 3 7 3 3 3 3 3 3 3 3 7 7 7 3 7 3 7 3 7 7 3 3 3 7 7 3 7 7 7 3
3 7 3 7 3 7 3 7 7 7 7 7 7 3 3 3 3 3 3 3 3 7 3 7 3 7 7 7 3 3 7 3 7 7 7 3 3 7 3 7 3 7 7 7 7 7 7 7 3 3 7 3 3 3 7 3 7 3 3 3 3 3 3 7 3 3 3 3 7 3
3 3 3 3 3 3 3 7 3 3 3 3 7 7 3 7 3 7 3 7 7 7 3 7 3 3 3 7 3 3 7 3 3 7 7 7 3 7 3 7 3 7 3 7 3 3 3 7 3 7 7 3 7 7 7 3 7 7 7 7 7 7 3 7 7 3 7 3 7 3
3 7 7 3 7 7 3 7 3 7 7 3 7 7 7 7 7 7 7 7 3 3 3 7 7 7 3 7 3 3 7 7 3 3 3 7 3 7 3 7 3 7 3 7 7 7 3 7 3 3 7 3 7 3 3 3 3 3 3 3 3 7 7 7 7 7 7 3 7 3
3 3 7 7 7 3 3 7 3 3 7 3 7 3 3 3 3 3 3 3 3 7 3 7 3 3 3 7 3 3 3 7 3 7 7 7 7 7 3 7 7 7 3 3 7 3 3 7 3 7 7 7 7 7 7 7 7 7 7 3 3 3 3 3 3 3 7 3 7 3
3 3 3 3 7 3 3 7 7 3 7 7 7 7 3 7 3 7 7 7 7 7 7 7 3 7 7 7 3 7 3 7 3 7 3 3 3 7 3 3 3 3 7 3 7 3 3 7 3 3 7 3 3 7 7 3 3 3 7 7 7 7 7 7 7 3 7 3 7 3
3 7 7 7 7 7 7 7 3 3 7 3 3 3 3 7 3 3 3 3 7 3 3 3 3 7 3 7 3 7 3 7 3 7 7 7 3 7 7 7 7 3 7 7 7 7 3 7 3 3 3 3 3 3 3 3 3 3 3 3 3 7 3 3 7 3 7 7 7 3
3 7 3 7 3 3 7 3 3 3 7 7 7 7 7 7 7 3 3 7 7 7 7 3 7 7 3 7 7 7 3 7 3 3 3 7 3 3 3 3 7 3 3 3 3 7 3 7 7 7 7 7 7 7 7 7 7 3 7 7 7 7 7 3 7 3 3 3 3 3
3 7 3 3 3 7 7 7 7 3 3 3 3 3 3 3 7 7 3 3 3 7 3 3 3 7 3 3 3 3 3 7 3 7 7 7 7 7 7 3 7 7 7 3 7 7 3 3 3 3 3 3 3 3 3 3 7 3 3 3 3 3 7 3 7 7 7 7 7 3
3 7 7 7 3 7 3 3 3 3 7 7 7 7 7 3 3 7 7 3 7 7 7 7 3 7 3 3 7 7 7 7 3 7 3 3 7 3 7 3 3 3 7 3 3 7 7 7 7 7 7 7 7 7 7 3 7 7 7 7 7 3 7 3 3 3 3 3 7 3
3 7 3 7 3 7 3 7 7 7 7 3 3 3 7 3 3 3 7 3 3 3 3 7 3 7 3 7 7 3 3 3 3 3 3 3 3 3 3 3 3 3 7 7 7 7 3 7 3 3 3 3 3 3 7 3 3 3 3 3 7 3 3 3 7 7 3 7 7 3
3 3 3 7 3 3 3 7 3 3 7 3 7 3 7 3 7 3 7 7 7 7 7 7 3 7 3 3 7 7 7 7 7 7 7 7 7 7 7 7 7 3 3 3 3 3 3 7 3 7 7 7 7 3 7 7 7 7 7 3 7 7 7 3 3 7 7 7 3 3
3 7 7 7 3 7 3 7 7 3 7 3 7 3 7 3 3 3 3 3 3 3 3 3 3 7 3 7 7 3 3 3 3 3 3 3 3 3 3 3 7 3 7 7 7 7 7 7 3 7 3 3 7 3 3 3 3 3 7 3 7 3 7 7 3 7 3 7 7 3
3 7 3 3 3 7 3 3 3 3 7 3 7 7 7 7 7 3 7 7 7 7 3 7 3 7 3 3 7 3 7 3 7 7 7 3 7 7 7 3 7 3 7 3 3 3 3 3 3 7 7 3 7 7 3 7 3 7 7 3 3 3 3 7 3 3 3 3 7 3
3 7 7 7 7 7 7 7 7 7 7 3 7 3 3 3 7 7 7 3 3 7 7 7 7 7 3 7 7 7 7 7 7 3 3 3 7 3 7 7 7 3 7 7 7 7 7 7 7 7 7 3 7 7 7 7 7 7 7 7 7 7 3 7 7 7 7 7 7 3
3 3 3 3 3 3 3 3 3 3 3 3 3 3 3 3 3 3 3 3 3 3 3 3 3 3 3 3 3 3 3 3 3 3 3 3 4 3 3 3 3 3 3 3 3 3 3 3 3 3 3 3 3 3 3 3 3 3 3 3 3 3 3 3 3 3 3 3 3 3
0 35
49 35