15 15
1 4 1 1 1 1 1 1 1 1 1 1 1 1 1
1 5 1 5 5 1 5 5 5 1 5 5 5 1 1
1 5 5 5 5 5 5 1 5 1 5 1 5 5 1
1 5 1 1 1 1 1 1 1 1 5 1 1 5 1 
1 5 5 1 5 5 5 1 5 5 5 1 5 5 1
1 1 5 5 5 1 5 1 5 1 5 1 5 1 1
1 5 5 1 5 1 1 1 1 1 5 1 5 5 1
1 5 1 1 5 5 5 5 5 5 5 1 1 5 1
1 5 5 1 1 1 1 5 1 1 1 1 5 5 1
1 1 5 5 5 5 1 1 1 5 5 1 5 1 1
1 5 5 1 5 5 5 1 5 5 5 5 5 1 1
1 5 1 1 5 1 1 1 5 1 1 1 1 1 1
1 5 5 1 1 1 5 1 5 5 5 1 5 5 1
1 1 5 5 5 1 5 5 5 1 5 5 5 5 1
1 1 1 1 1 1 1 1 1 1 1 1 1 4 1
0 1
14 13