30 40
2 2 2 2 2 4 2 2 2 2 2 2 2 2 2 2 2 2 2 2 2 2 2 2 2 2 2 2 2 2 2 2 2 2 2 2 2 2 2 2
2 2 2 2 2 6 2 2 2 2 6 6 6 2 2 6 6 6 6 6 2 2 2 2 2 2 6 6 6 6 2 2 2 2 2 2 6 6 2 2
2 6 6 6 6 6 6 6 6 6 6 2 6 6 2 6 2 2 2 6 6 6 6 6 6 2 6 2 2 6 2 6 6 6 6 6 6 6 6 2
2 6 2 2 2 2 2 2 2 2 2 2 2 2 2 6 2 6 2 2 2 6 2 2 6 2 6 2 6 6 2 6 2 2 6 6 2 2 6 2
2 6 6 6 6 6 6 6 6 6 6 6 6 6 6 6 2 6 6 6 6 6 6 2 6 6 6 2 2 2 2 6 2 2 2 6 2 2 2 2
2 2 2 6 2 2 2 2 2 2 2 2 2 2 2 2 2 2 2 6 2 6 2 2 6 2 6 6 2 6 6 6 2 6 2 6 6 6 6 2
2 6 2 6 2 6 2 2 2 2 2 2 2 2 2 2 2 2 2 2 2 6 2 2 6 2 2 2 2 6 2 2 2 6 2 2 2 2 6 2
2 6 2 6 2 6 2 6 6 6 6 6 6 6 6 6 6 6 6 6 2 6 6 2 6 6 6 6 6 6 2 6 6 6 6 6 6 2 6 2
2 6 6 6 6 6 2 6 2 2 6 2 2 2 2 2 2 2 2 6 2 2 6 2 2 2 2 2 2 2 2 6 2 2 2 2 2 2 6 2
2 2 2 2 2 2 2 6 2 6 6 2 6 2 6 6 6 6 6 6 2 6 6 6 6 6 6 6 6 6 6 6 6 2 6 6 6 6 6 2
2 2 6 6 6 6 6 6 2 2 6 2 6 2 6 2 2 2 2 2 2 2 2 2 2 2 2 2 2 2 2 6 2 2 6 2 6 2 2 2
2 2 6 2 2 2 2 2 2 6 6 2 6 2 6 6 6 6 6 6 6 6 6 6 6 6 6 2 2 6 2 6 2 2 6 2 6 6 6 2
2 2 6 2 6 2 6 2 2 6 2 2 6 2 2 2 2 2 2 2 2 2 2 2 2 2 6 2 6 6 2 6 6 2 6 2 6 2 6 2
2 2 6 2 6 6 6 6 6 6 6 2 6 2 6 6 6 6 6 6 6 6 2 2 2 2 6 2 6 2 2 6 2 2 6 2 6 6 6 2
2 2 6 2 2 6 2 2 2 2 6 2 6 2 2 2 2 2 2 2 2 6 2 6 6 6 6 2 6 6 6 6 6 2 6 2 2 2 2 2
2 2 6 2 2 2 2 6 6 6 6 6 6 6 6 2 2 2 2 6 2 6 2 6 2 2 2 2 6 2 2 2 6 2 6 6 6 6 2 2
2 2 6 6 6 2 2 2 2 2 2 2 2 6 2 2 6 2 2 6 2 6 2 6 2 6 6 6 6 6 6 2 2 2 2 2 2 6 2 2
2 2 2 2 6 6 6 6 6 6 6 2 2 6 6 2 6 6 2 6 2 6 2 6 2 2 2 2 2 2 2 2 2 2 2 2 2 6 2 2 
2 2 6 2 2 6 2 2 2 2 6 2 6 6 6 6 6 6 6 6 6 6 2 6 6 6 6 6 6 6 6 6 6 6 6 6 6 6 2 2
2 6 6 6 6 6 6 6 6 2 6 2 2 6 2 2 2 2 2 2 2 6 2 2 2 2 2 2 2 2 2 2 2 2 2 2 2 2 2 2
2 6 2 2 2 2 2 2 6 2 6 2 2 2 2 2 2 2 2 6 6 6 6 6 6 6 6 6 6 6 6 6 2 2 6 6 6 6 6 2 
2 6 2 6 6 6 6 2 6 2 6 6 6 6 6 6 6 6 2 2 2 2 2 2 2 2 2 2 2 2 2 6 6 6 6 2 2 2 2 2
2 6 2 6 2 2 6 2 6 2 2 2 2 2 2 2 2 6 2 2 6 6 6 6 6 6 6 2 6 2 2 6 2 2 2 2 6 6 6 2
2 6 2 6 2 2 6 2 2 2 2 2 2 2 2 2 2 6 2 2 6 2 2 2 2 2 6 2 6 2 2 6 2 6 6 2 6 2 6 2
2 6 2 6 2 2 6 6 6 6 6 6 6 6 6 6 6 6 2 2 6 2 6 6 6 2 6 2 6 6 6 6 6 6 2 2 6 2 6 2
2 6 2 6 2 2 2 2 2 2 2 2 2 2 2 2 2 2 2 2 6 2 6 2 6 2 6 2 2 2 2 2 2 6 2 2 6 2 6 2
2 6 2 6 2 2 2 2 2 2 2 2 6 6 6 6 6 6 6 6 6 2 6 2 6 2 6 6 6 6 6 2 2 2 2 2 6 2 6 4
2 6 2 6 6 6 6 6 2 2 2 2 6 2 2 2 2 2 6 2 2 2 6 2 6 2 2 2 2 2 6 2 6 6 6 2 6 2 2 2
2 6 2 2 2 2 2 6 6 6 6 6 6 2 6 6 6 6 6 6 6 6 6 6 6 6 6 6 6 2 6 6 6 2 6 6 6 2 2 2
2 2 2 2 2 2 2 2 2 2 2 2 2 2 2 2 2 2 2 2 2 2 2 2 2 2 2 2 2 2 2 2 2 2 2 2 2 2 2 2
0 5
26 39